(0,0)->(11,2);(11,2)->(0,0)
OY #    $ Y$Y|
 X          Y|
  T # T   $O |
 T       T  T|
#Y   #  TT# #|
Y T $    Y ##|
      Y T $  |
TT   Y  Y#Y T|
 $ #    # $  |
  $ # Y   T  |
T    T     P#|
  Y $  Y T  Y|